W, , , , , , , , , , , , , , , , , , , , , , , ,W,
 , , , , , , , , , , , , , , , , , , , , , , , , ,
W, , , , , , , , , , , , , , , , , , , , , , , ,W,
 , , , , , , , , , , , , , , , , , , , , , , , , ,
W, , , , , , , , , , , , , , , , , , , , , , , ,W,
 , , , , , , , , , , , , , , , , , , , , , , , , ,
W, , , , , , , , , , , , , , , , , , , , , , , ,W,
 , , ,S, , , , , , , , , , , , , , , , , , , , , ,
W, , , , , , , , , , , , , , , , , , , , ,G, , ,W,
 , , , , , ,L, , ,R, , , , , ,L, , , , , , , , , ,
W, ,W, ,W, , , , , , , , , , , , , , , ,W, ,W, ,W,
 , , , , , , , , , , , , , , , , , , , , , , , , ,
W, , , , , , , , , , , , , , , , , , , , , , , ,W,
 , , , , , , , , , , , , , , , , , , , , , , , , ,
W, , , , , , , , , , , , , , , , , , , , , , , ,W,
 , , , , , , , , , , , , , , , , , , , , , , , , ,
W, , , , , , , , , , , , , , , , , , , , , , , ,W,
 , , , , , , , , , , , , , , , , , , , , , , , , ,
F, ,F, ,F, ,F, ,F, ,F, ,F, ,F, ,F, ,F, ,F, ,F, ,F,