W, , , , , , , , , , , , , ,W, , , , , , , , , ,W,
 , , , , , , , , , , , , , , , , , , , , , , , , ,
W, , , , , , , , , , , , , ,W, , , , , , , , , ,W,
 , , , , , , , , , , , , , , , , , , , , , , , , ,
W, , , , , , , , , , , , , ,W, , , , , , , , , ,W,
 , , , , , , , , , , , , , , , , , , , , , , , , ,
W, , , , , , , , , , , , , ,W, , , , , , , , , ,W,
 , , , , , , , , , , , , , , , , , , , , , , , , ,
W, , , , , , , , ,M, , , , ,W, , , , , , , , , ,W,
 , , , , , , , , , , , , , , , , , , , , , , , , ,
W, , , , , , , ,W, ,W, , , , , , , , , , , , , ,W,
 , , , , , , , , , , , , , , , , , , , , , , , , ,
W, ,B, ,B, ,B, ,W, ,W, , , , , , , ,W, , , , , ,W,
 , ,P, ,P, ,P, , , , , , , , , , , , , , , , , , ,
W, , , , , , , , , , , , , , , , , ,W, , ,G, , ,W,
 , , , , , , , , , , , , , , , , , , , , , , , , ,
W, , , , , , , , , , , , , , , , , ,W, ,W, ,W, ,W,
 , , , , , , , , , , , , , , , , , , , , , , , , ,
F, ,F, ,F, ,F, ,F, ,F, ,F, ,F, ,F, ,F, ,F, ,F, ,F,